####..#########################.
.....#..........................
.###############.###############
#.##.#.....................#..#.
#.##.############.#.#######..#..
#..#.############..#######.#.#.#
#.##.#............#........#....
#.##.#######.################.##
#.##....................##.#.##.
#.##.########x########.#.#.#.##.
#.##.###########..#####.##.#.##.
..#..#...........#......#..#....
#.#.##################.##.#..#.#
#..#.##################..#.#..#.
..#..#..................#..#s#..
